R 800 600

NO ./texture/redbrick.xpm

SO ./texture/greystone.xpm

WE ./texture/wood.xpm

EA ./texture/bluestone.xpm

S ./texture/barrel.xpm


C 0,200,255

F 0,10,40

        1111111111111111111111111
        1000000000110200000000021
        1001002001110000202020001
        1001000000000000000000001
111111111011000001112000000000021
100000000011000001110111110111111
11110111001111011100000012021
11110111111111011101010010001
11000000110101011100000010001
10002000000000001100000010001
10000000000000001101010010001
11000001110101011111011110N0111
11110111 1110101 101111012021
11111111 1111111 111111111111
